10 35
###################################
#&#,,,,,#@,,,,,,,,,,,,,#,,,,,,,,,&#
#,#@#,#,####,#######,#,#,,,#,,#####
#,###,#,,,,,,,,,,,,,,#@#,###,,#,,,#
#,,,,,,,,#########,#,###,#,,,,#,#,#
#,#,####,#,,,,,,,,P#,,,,,#,####,#,#
#,#&,,,#,#,#######,#,,,#,,,,,,,,#,#
#,####,#,#,#@#,,,#,#,#,#,#,######,#
#,,,,,,,,,,,,,,#,,,,,#,,,#,,,,,,,&#
###################################